....................
....................
....................
....................
....................
.......#E###........
.......#.#.E........
.......#####........
.......E.#.#........
.......###E#........
....................
.........H..........
....................
.........P..........
....................
